images/bricks.bmp
images/start.bmp
images/path.bmp
images/gold.bmp
images/boss.bmp
images/heart.bmp
images/door.bmp
images/maggie.bmp
17 19
w w w w w w w w w w w w w w w w w w w
w b w c c c c c c h w c c c w w c c w
w c c c w c w w w w w c w b c c c w w
w w w w w c w c c c w c w w w w c w w
w c c c c c w c w c w c c c c w c c g
w c w w w w w c w c w w w w c w w w w
w h c c c c c c w b c c c c c c c c w
w w w w w c w c w w w w w c w w w c w
w c c c c c w c c c c c w c w h w c w
w c w w w w w w w w w c w c w c w h w
w c c c c b w c c c w c w c w c w w w
w w w c w c c c w c w c w c w b c c w
w c w c w w w c w c w w w c w w w c w
w c w c c h w c w c c c w c c c w c w
w c w w w w w c w w w h w w w c w c w
s c c c c c c c w c c c c b w c c c w
w w w w w w w w w w w w w w w w w w w
